ABS=Absaroka
ABU=Trucial States
ACE=Aceh
ACH=Acholi
ADG=Adagh
AFG=Afghanistan
AFS=Free State
AGJ=Angola Janga
AHG=Ahaggar
AHU=Anhui
AIN=Ainu Mosir
AIR=Air
ALB=Albania
ALT=Los Altos
AMZ=Amazonia
ANH=Anhalt
ANK=Ankole
ANL=Andalusia
AOT=Aotearoa
APC=Apache
ARA=Arabia
ARG=Argentina
ARM=Armenia
ARP=Arapaho
ASA=New Africa
ASH=Ashanti
ASM=Assam
ASS=Assyria
AST=Australia
ATB=Athabaska
AUS=Austria
AWA=Awadh
AWS=Aussa
AYI=Anyi
AYM=Aymara
AZB=Azerbaijan
BAD=Baden
BAH=Bahamas
BAL=Bali
BAS=Bastar
BAV=Bavaria
BEL=Belgium
BEN=Benin
BER=Baroda
BGI=Bagirmi
BGL=Bengal
BGM=Begemder
BHN=Bahrain
BHO=Bhopal
BHT=India
BHU=Bhutan
BIC=East India Company
BIK=Bikaner
BJA=Beja
BLA=Bilua
BLE=Baule
BLF=Niitsitapi
BLG=Bulungan
BLH=Baluchistan
BMB=Bemba
BND=Bundu
BNG=Bangala
BNJ=Banjar
BNY=Bunyoro
BOB=Bobangi
BOH=Bohemia
BOL=Bolivia
BOR=Bornu
BOS=Bosnia-Herzegovina
BRA=Brunswick
BRD=Burundi
BRE=Bremen
BRI=Brittany
BRN=Borana
BRU=Brunei
BRZ=Brazil
BSS=Bassa
BST=Basuto
BTG=Batonga
BTN=Buton
BUG=Buganda
BUK=Bukhara
BUL=Bulgaria
BUN=Bundelkhand
BUR=Burma
BYE=Belarus
BYZ=Byzantium
CAL=California
CAM=Cambodia
CAN=Canada
CAS=Castile
CAT=Catalonia
CAY=Cayor
CCM=O'odham Country
CEY=Ceylon
CHC=Chechnya
CHE=Cherokee
CHI=China
CHK=Chokwe
CHL=Chile
CHP=Champassak
CHW=Chewa
CIR=Circassia
CLM=Colombia
CMI=Chiang Mai
COB=Saxe-Coburg-Gotha
COL=Columbia
COM=Comanche
COR=Corsica
COS=Costa Rica
CRE=Crete
CRI=Crimea
CRO=Croatia
CSA=Confederate States of America
CSC=Cascadia
CTF=Council of Three Fires
CUB=Cuba
CYP=Cyprus
CZH=Czechoslovakia
DAG=Dagestan
DAH=Dahomey
DAI=Dai Nam
DAK=Dar al Kuti
DEI=Dutch East Indies
DEN=Denmark
DES=Deseret
DFR=Darfur
DFT=Dar Fertit
DKT=Dakota
DLA=Duala
DNK=Dinka
DOM=Santo Domingo
DON=Don Cossack Host
DZG=Danzig
ECU=Ecuador
EGY=Egypt
ELS=El Salvador
ENG=England
EOT=Emirate of Transjordan
EQU=Equatoria
EST=Estonia
ETH=Ethiopia
EWE=Ewe
EZO=Ezo
FER=Kamchatka
FIN=Finland
FJI=Fiji
FLA=Flanders
FNG=Fang
FRA=France
FRM=Frankfurt
FRS=Formosa
FSA=Free States of America
FTJ=Futa Jallon
FTR=Futa Toro
GAL=Galicia-Lodomeria
GAO=Gao
GBR=Great Britain
GCO=Gran Colombia
GEO=Georgia
GGO=Gogo
GJM=Gojjam
GLD=Geledi
GLI=Galicia
GML=Gamilaraay
GNG=Da Cheng
GNI=Guarani
GRE=Greece
GRI=Guarani
GRN=Greenland
GUA=Guatemala
GUI=Guizhou
GWA=Gwalior
HAI=Haiti
HAM=Hamburg
HAN=Hanover
HAR=Harar
HAU=Damagaram
HBC=Hudson Bay Company
HDJ=Hedjaz
HEK=Hesse-Kassel
HES=Hesse
HHE=Hehe
HLA=Halia
HMB=Hemba
HNA=Hunan
HND=India
HOB=Hobyo
HOH=Hohenzollern
HOL=Holstein
HON=Honduras
HRO=Herero
HTH=Hathawaddy
HUN=Hungary
HYD=Hyderabad
HZJ=Hazarajat
IBE=Iberia
IBL=
IBO=Igbo
ICL=Iceland
IDN=Indonesia
IND=Indore
ION=Ionian Islands
IRC=Iron Confederacy
IRE=Ireland
IRO=Haudenosaunee
IRQ=Iraq
ISQ=Isaaq
ISR=Israel
ITA=Italy
IUS=Kazan
JAB=Jabal Shammar
JAI=Jaipur
JAM=Jamaica
JAN=Jan Mayen
JAP=Japan
JAS=Jaisalmer
JAV=Java
JLF=Jolof
JMB=Jambi
JOD=Jodhpur
JOH=Johore
KAL=Kalat
KAS=Kashmir
KAT=Kathiri
KAZ=Kazakhs
KBA=Kuba
KBD=Kabadougou
KBU=Kaabu
KFA=Kaffa
KHI=Khiva
KHM=Khmu
KHN=Kachin
KKY=Kikuyu
KLM=Kalmykia
KLT=Kalimantan
KNG=Kong
KNK=Kanak
KOK=Kokand
KON=Kongo
KOR=Korea
KRA=Krakow
KRG=Karagwe
KRN=Karen
KRT=Kaarta
KRU=Kru
KSN=Kasanje
KSS=Kissi
KTI=Kutai
KUK=Danubian State
KUR=Kurdistan
KUT=Kutch
KZM=Kazembe
LAD=Ladakh
LAH=Lahej
LAN=Lanfang
LAO=Laos
LAT=Latvia
LBA=Luba
LEB=Lebanon
LGA=Lega
LIB=Liberia
LIP=Lippe
LIT=Lithuania
LKT=Lakota
LMW=Lomwe
LND=Lunda
LNG=Loango
LOM=Lombardia
LOU=Louisiana
LUA=Luang Prabang
LUB=Lübeck
LUC=Lucca
LUO=Luo
LUX=Luxembourg
LZO=Barotse
MAD=Madagascar
MAH=Mahra
MAK=Makran
MAL=Mali
MAY=Maya
MCH=Manchuria
MCO=Michoacán
MCR=Micronesia
MDK=Mandinka
MEC=Mecklenburg
MEI=Saxe-Meiningen
MEW=Mewar
MEX=Mexico
MGD=Maguindanao
MGL=Mongolia
MJT=Majerteen
MKT=Miskitia
MKU=Makua
MLT=Malta
MNB=Mangbetu
MNC=Manica
MNP=Manipur
MOD=Modena
MOL=Moldavia
MON=Montenegro
MOR=Morocco
MOS=Mossi
MSC=Muscogee
MSH=Mashona
MSI=Masai
MSK=Maseko
MSN=Massina
MST=Mecklenburg-Strelitz
MTB=Matabele
MTC=Métis
MUG=Hindustan
MUI=Muisca
MYS=Mysore
NAG=Nagpur
NAH=Anahuac
NAL=Natalia
NAM=Nama
NAS=Nassau
NAV=Navarra
NBA=Nuba
NBS=New Brunswick
NCA=Mountain Republic
NEJ=Nejd
NEN=New England
NEP=Nepal
NET=Netherlands
NEW=Newfoundland
NGF=North German Federation
NIC=Nicaragua
NNG=Noongar
NNV=Nunavut
NOR=Norway
NRU=Nauru
NSW=New South Wales
NTO=Ngāti Toa
NTU=Ngāi Tahu
NUE=Nuer
NVJ=Navajo
NVL=Navajoland
NVS=Nova Scotia
NYM=Nyamwezi
NZL=New Zealand
NZP=Nimíipuu
OAX=Oaxaca
OCC=Occitania
OLD=Oldenburg
OMA=Oman
ONT=Ontario
ORA=Oranje
ORG=Oregon
ORI=Orissa
ORN=Orinoco
OUA=Oualata
OVM=Ovimbundu
OYO=Oyo
PAL=Palestine
PAN=Punjab
PAP=Rome
PAR=Parma
PAT=Mapuche
PCO=Puerto Rico
PER=Persia
PEU=Peru
PHI=Philippines
PLC=Poland-Lithuania
PLY=Tahiti
PNI=Piratini
PNM=Panama
POL=Poland
POM=Pomerania
PON=Pontianak
POR=Portugal
PPU=Papua
PRA=Grão-Pará
PRG=Paraguay
PRK=Perak
PRM=Perm
PRU=Prussia
PUE=Pueblo
PWN=Pawnee
QIA=Qian
QUE=Quebec
RIO=Río Grande
ROM=Romania
RUS=Russia
RWD=Rwanda
SAF=South Africa
SAH=Sahrawi
SAK=Siak
SAR=Sardinia-Piedmont
SAS=South Australia
SAX=Saxony
SCA=Scandinavia
SCH=Schleswig
SCM=Schaumburg-Lippe
SCN=Scania
SCO=Scotland
SCW=Schwarzburg
SDM=Sidamo
SEL=Selangor
SEQ=Indian Territory
SER=Serbia
SGF=South German Federation
SGU=Segou
SHA=Shandong
SHN=Shanxi
SHW=Shewa
SIA=Siam
SIB=Siberia
SIC=Two Sicilies
SIH=Sichuan
SIK=Sikkim
SIL=Sierra Leone
SIN=Sindh
SKH=Sakhalin
SKM=Sukuma
SLK=Selk'nam
SLO=Slovenia
SLV=Slovakia
SLW=Sulawesi
SMB=Sambas
SMI=Sapmi
SNA=Sena
SNG=Sangu
SOK=Sokoto
SPA=Spain
SRA=Sara
SRB=Sorbia
SRK=Surakarta
SRR=Serer
SSU=Susu
STG=Sintang
SUD=Sudan
SUL=Sulu
SWE=Sweden
SWI=Switzerland
SYR=Syria
TAS=Tasmania
TBI=Tibesti
TEX=Texas
TGR=Tigray
THL=Tehuelche
TIB=Tibet
TID=Tidore
TIR=Tiris
TIV=Tivland
TKE=Teke
TNG=Tonga
TNS=Tungus
TOB=Toba
TPG=Heavenly Kingdom
TPI=Tupinamba
TPS=Toposa
TRA=Travancore
TRC=Turkmenia
TRE=Trieste
TRH=Turkestan
TRI=Tripolitania
TRK=Turkana
TRN=Transvaal
TRS=Transylvania
TRZ=Trarza
TSW=Tswana
TUA=Tuat
TUN=Tunis
TUR=Turkey
TUS=Tuscany
TUV=Tuva
TWT=Tawantinsuyu
UBD=United Baltic Provinces
UCA=Central America
UKR=Ukraine
ULR=Uluru
ULS=Ulster
UNT=United Tribes
UOM=Michigan
URU=Uruguay
USA=America
UTE=Ute
UYA=Uyao
VEN=Venice
VIE=Vientiane
VNT=Vanuatu
VNZ=Venezuela
WAD=Wadai
WAL=Wallachia
WAS=Western Australia
WBL=Griqualand
WEI=Saxe-Weimar
WES=Westphalia
WIN=West Indies
WLD=Waldeck
WLG=Welega
WLL=Wallonia
WLO=Wello
WLS=Wales
WSG=Warsangali
WUR=Württemberg
WYU=Wayuu
XHO=Xhosa
XIB=Xibei
XIN=Uyghuristan
YAK=Yakutia
YEM=Yemen
YKA=Yaka
YOG=Yogyakarta
YUC=Yucatán
YUE=Yue
YUG=Yugoslavia
YUN=Yunnan
ZAI=Azal
ZAN=Zanzibar
ZHI=Zhili
ZIM=Zimbabwe
ZND=Azande
ZUL=Zulu
